12 21 50
#####################
#..........#........#
#..........#........#
#...####...#######..#
#...#...............#
#...#...............#
#...####.......#....#
#......#.......#....#
#......#...#####....#
#..........#........#
#..........#........#
#####################