9 30 38
##############################
#....#.......#.......##......#
#....#...............##......#
#....#.......#...............#
#.#..#.......#.....#....######
#............#.....#.........#
#....#...#####.....#....####.#
#....#.............#.........#
##############################