13 32 36
################################
#.....#.......#......#...#.....#
#.....#..##...#......#...#.....#
#..####.......#..........###...#
#..#.......##########....#.....#
#..............................#
#..............................#
####....###....#####.....##....#
#.........................#....#
####.......#..............#....#
#..#.......#......###.....#....#
#..............................#
################################