7 6 70
######
#....#
#.#..#
#....#
#..#.#
#....#
######