6 39 32
#######################################
#.....#.......#...........#........#..#
###...#...#........####...#...#....##.#
#.........#........#......#...#.......#
#.....#.......#....#..................#
#######################################