18 18 35
##################
#................#
#................#
#................#
#................#
#....##....##....#
#................#
#................#
#................#
#................#
#................#
#................#
#....##....##....#
#................#
#................#
#................#
#................#
##################