9 27 40
##########################
#........................#
#.....####....#...#...#..#
#....#........#...#...#..#
#...#..####...#...#..#...#
#....#....#....#..#..#...#
#.....####.....######....#
#........................#
##########################